01111000000000000000-
01001000000000000000-
01001111110000000000-
01000000010000000000-
11000000010000111000-
00000000011001101000-
00000000001111001000-
00000000000000001000-
00000000000000001111-
00000000000000000000